beat|beat|beaten|Golpear|
bend|bent|bent|Doblar|
bind|bound|bound|Atar|
bite|bit|bitten|Morder|
bleed|bled|bled|Sangrar|
blow|blew|blown|Soplar|
break|broke|broken|Romper|
breed|bred|bred|Criar|
build|built|built|Construir|
burst|burst|burst|Estallar|
buy|bought|bought|Comprar|
catch|caught|caught|Atrapar|
choose|chose|chosen|Elegir|
cut|cut|cut|Cortar|
deal|dealt|dealt|Tratar|
dig|dug|dug|Cavar|
do|did|done|Hacer|
draw|drew|drawn|Dibujar|
drink|drank|drunk|Beber|
drive|drove|driven|Conducir|
eat|ate|eaten|Comer|
fall|fell|fallen|Caer|
feel|felt|felt|Sentir|
find|found|found|Encontrar|
forget|forgot|forgotten|Olvidar|
forgive|forgave|forgiven|Perdonar|
freeze|froze|frozen|Congelar|
give|gave|given|Dar|
go|went|gone|Ir|
grow|grew|grown|Crecer|
hang|hung|hung|Colgar|
have|had|had|Tener|
hear|heard|heard|Oir|
hide|hid|hidden|Esconder|
hold|held|held|Sostener|
hurt|hurt|hurt|Herir|
read|read|read|Leer|
run|ran|run|Correr|
know|knew|known|Conocer|